NO ./path_to_the_north_texture.xpm
SO ./path_to_the_south_texture.xpm
WE ./path_to_the_west_texture.xpmm
EA ./path_to_the_east_texture.xpm


F 220,100,0
C 225,30,0

         11111111111111111111111
         10000000000000000000001
         10000001111110000000001
11111111110000001    10000000001
100W0000100000001    10000011111
1000000010000000111111000001
1111111111110000000001001111
           10001000111111
    1111111100010001
    10000000000100011111111
    11111111000000000000001
           1000000000000001
111111111111000000100000101
100000000000000000100000001
111111111111111111111111111