       NO ./texture/base/wall_n.xpm        
   SO ./texture/base/wall_s.xpm      
                          WE ./texture/base/wall_w.xpm    
      EA ./texture/base/wall_e.xpm     

             F          0,0,120
      C    0,100,0

1111111111111111111
1000000000000000001
1000000000000000001
1000000000000000001
1000000001000000001
1000000001000000001
1000000111110000001
1000000001000000001
1000000001000000001
1000000001000000001
1000000001000000001
1000000000000000001
1000000000000000001
100000000N000000001
1111111111111111111