NO ./path_to_the_north_texture
SO ./path_to_the_south_texture
WE ./path_to_the_west_texture
EA ./path_to_the_east_texture


F 220,100,0
C 225,30,0

11111    11111111111111111111111
10001    10000000000000000000001
10S01    10000001111110000000001
10001111110000001    10000000001
10000000100000001    10000011111
1000000010000000111111000001
1111111111110000000001001111
           10000000111111
    1111111100000001
    10000000000000011111111
    11111111000000000000001
           1000000000000001
           1111111111111111