NO ./path_to_the_north_texture.xpm
SO ./path_to_the_south_texture.xpm
WE ./path_to_the_west_texture.xpm
EA ./path_to_the_east_texture.xpm

F 220,100,0
C 225,30,0

          111111111111111111111
         10000000000000000000001
         100S0001111110000000001
 1111111110000001    10000000001
10000000000000001    1000001111
1000000000000000111111000001
 11111111111000000000100111
           1000100011111
    111111100010001
    1000000000010001111111
     1111111000000000000001
       10000000000000000001
 11111111111000000100000001
100000000000000000100000001
 1111111111111111111111111