NO ./texture/wall_n.xpm
SO ./texture/wall_s.xpm
WE ./texture/wall_w.xpm
EA ./texture/wall_e.xpm

F 0,0,120
C 0,100,0

 1111111111111
100000000000001
101100111001101111111111
1000000000001000000000001
1000001000000000000000001
1011001000011W00000000001
1000000000000000000000001
100000000000001111111111
101010000010101
 1111110011111
      1001
      1001
      1001
       11
