NO ./texture/wall_n.xpm
SO ./texture/wall_s.xpm
WE ./texture/wall_w.xpm
EA ./texture/wall_e.xpm

F 0,32,0
C 32,32,32

111111111111111
100000000000001
101100111001101
100000000000101
100000100000001
1011001000011N1
100000000000001
100000000000001
101010101010101
111111111111111
