NO ./path_to_the_north_texture.xpm
SO ./path_to_the_south_texture.xpm
WE ./path_to_the_west_texture.xpm
EA ./path_to_the_east_texture.xpm

F 255,128,196
C 91,193,255

111111111111111
100000000000001
101100111001101
100000000000101
100000100000001
101100100001101N
100000000000001
100000000000001
101010101010101
111111111111111
