NO ./path_to_the_north_texture.xpm
SO ./path_to_the_south_texture.xpm
WE ./path_to_the_west_texture.xpm
EA ./path_to_the_east_texture.xpm

F 255,128,196
C 91,193,255

 111111111111111111111111111111
10000010000000000000000000000001
10000010000000000000000000000001
10000010000000000000000000000001
10000000000011111110000000000001
100000000001       1000000000001
100000000001       1000000000001
100000000001       1000000000001
10000000000011111110000000000001
10000000000000000000000000000001
10000000000000000000000000000001
100000000N0000000000000000000001
 111111111111111111111111111111