NO ./path_to_the_north_texture.xpm
SO ./path_to_the_south_texture.xpm
WE ./path_to_the_west_texture.xpm
EA ./path_to_the_east_texture.xpm

F 220,100,0
C 225,30,0

 111111111111111111111111111111
10000000000000000000000000000001
10000000000000000000000000000001
10000000000000000000000000000001
10000000000001111110000000000001
1000000000001      1000000000001
100000000001        100000000001
1000000000001      1000000000001
10000000000001111110000000000001
10000000000000000000000000000001
1000N000000000000000000000000001
10000000000000000000000000000001
 111111111111111111111111111111