NO ./texture/cursed/meth.xpm
SO ./texture/cursed/simba.xpm
WE ./texture/cursed/shaq.xpm
EA ./texture/cursed/freakbob.xpm

F 100,100,0
C 100,154,0

1111111111111111111
1000000000001000001
1001111111110000001
1000000000000000001
1000000001000110001
1000110001000000001
1000000000000000001
1000000001000000001
1000000001000000001
1000000001000001001
1110001111000001001
1000000000001000001
1000100000001000001
101000000N000110001
1111111111111111111