NO ./texture/fish/baluk.xpm
SO ./texture/fish/smoking_fish.xpm
WE ./texture/fish/shouting_fish.xpm
EA ./texture/fish/fish.xpm

F 0,0,120
C 0,100,0

1111111111111111111
1000000000001000001
1000000011111110001
1000000000000000001
1000000001000000001
1000000001000000001
1111111111110000001
1000000001000000001
1000000001000000001
1000000001000001001
1110001111000001001
1000000000001000001
1000100000001000001
101000000N000000001
1111111111111111111