NO    ./texture/fish/baluk.xpm    
SO          ./texture/fish/smoking_fish.xpm    
WE       ./texture/fish/shouting_fish.xpm    
EA           ./texture/fish/fish.xpm    

F 0,0,120
C 0,100,255

       1111111111
1     100000000001
11   10000000000001
111 1000000000010001
11111000000000000001
111 10000000N0100001
11   10000000001101
1     100000000001
       1111111111