       NO          ./texture/base/wall_n.xpm        
   SO ./texture/base/wall_s.xpm      
WE ./texture/base/wall_w.xpm    
      EA ./texture/base/wall_e.xpm     

         F             0,0,255
          C            0  ,  255   ,    0    

1111111111111111111
1000000000000000001
1000000000000000001
1001000000001000001
1001000000001001001
1001000000001001001
1000000000000000001
1000000000000000001
1000000000000000001
1001001000001000001
1001001000001000001
1001001000001011001
1000000000000000001
100000000000N000001
1111111111111111111